. . . . . . . . . . . . . . . . . . . . . . . . | . . . . . . . . . . . . . . . . . . . . . . . . . . . . . . . . . . . C . . .
. . . . . . . . . . . . . P P P . . . . . . . . | . C . . . . . . . . . . . . . . . . . . . . P P P . . . . . . . . P P P P . .
. . . . . . . C . . . . . . . . . . . . . . P P | P P P P . . . . . . . . . C . . . . . . . . . . . . . . . . . . . . . . . . .
. . . . . P P P P . . . . . . . . . . . . . . . | . . . . . . . . . . . . P P P P P . . . . . . . . . . . . . . . . . . . . . .
. . . . . . . . . . . . . . C . . . . . . . . . | . . . . . . . . . . . . . . . . . . . C . . . . . . . . . P P . . . . . . . .
. P P P . . . . . . . . P P P P P P . . . . . . | . P P P P . . . . . . . . . . . . . P P P P P . . . . . . . . . . . C . . . .
. . . . . . . . . . . . . . . . . . . . . . . . | . . . . . . . P P P . . . . . . . . . . . . . . . . . . . . . . . P P . . . .
. . . . . . . . . . . . . . . . . . P P P . . . | . . . . . . . . . . . . P P . . . . . . . . . . . . P P . . . . . . . . . . .
. . . . P P P P . . . . . . . . . . . . . . . . | . C . . . . . . . . . . . . . . . . C . . . . . . . . . . . . . . . . . . . .
. . . . . . . . . . P P P P . . . . . . . . . P | P P . . . P P P P . . . . . . . . P P P . . . . . . . . . . . . . . . P P . .
. . . . . . . . . . . . . . . . . . . . . . . . | . . . . . . . . . . . . . . . . . . . . . . . . . . . . . . . . . . . . . . .
. H . C . . . . . . . . . . . . . . . . . . . . | . . . . . . . . . . . . . . . . . . . . . . . . . . . . . . . . . . . . . . .
G G G G G . . G G G G G G G G G G G . . . G G G | G G G . . . . G G G G G G G . . G G G G G G . . . G G G G . . G G G G G G G G
D D D D D . . D D D D D D D D D D D . . . D D D | D D D . . . . D D D D D D D . . D D D D D D . . . D D D D . . D D D D D D D D
D D D D D . . D D D D D D D D D D D . . . D D D | D D D . . . . D D D D D D D . . D D D D D D . . . D D D D . . D D D D D D D D