. . . . . . . . . . . . . . . . . . . . . . . . | . . . . . . . . . . . . . . . . . . . . . . . . . . . . . . . . . . . . . . .
. . . . . . . . . . S S S S S . . . . . . C . . | . . . . . . . C . . . . . . . . . . . . . . . . . . . . . . . . . . . . . . .
. . . . . . . . . . . . . . . . . . . . . S S . | . . . . . . . S . . . . . . . . . . . . . . . . . . . . . . . . . . . . . . .
. . . . C . . . . . . . . . . . . . . . . . . . | . . . . . . . . . . . . . . . . . . . . . . . . . . . . . . . . . . . . . . .
. . . S S S S S . . . . . . . . . . S S S . . . | . . . . . . . . . . . . . . . S S . . . . . . . . . . . . . . . . . . . . . .
. . . . . . . . . . . . . H . . . . . . . . . . | . . . S S . . . . . . . . . . . . . . . . . . . . . . . . . . . . . . . . . .
. . . . . . . . . . . . S S S . . . . . . . . . | . . . . . . . . . . . . . . . . . . . . . . . . . . . . . . . . . . . . . . .
. . . . . . . . . . . . . . . . . . . . . . . . | . . . . . . . . . . . S S S S . . . . . . . . . . . . . . . . . . . . . . . .
. . . . . . . . . . . . . . . . . . . . S S S S | . . . . . . . . . . . . . . . . . . . . . . . . . . . . . . . . . . . . . . .
. . . . . . S S . . . . . . . . . . . . . . . . | . . . . . . . S . . . . . . . . . . . . . . . . . . . . . . . . . . . . . . .
. . S . . . . . . . . . . . . . . S . . . . . . | . . C . . . . . . . . . S S . . S S . . . . . . . . . . . . . . . . . . . . .
. . . . . . . . . . . . . . . . . . . . . . . . | . S S S . . . . . S . . . . . . . . . . . . . . . . . . . . . . . . . . . . .
. . . . . . . . . . S S S S . . . . . . . . . . | . . . . S . . . . . . . . . . . . . . . . . . . . . . . . . . . . . . . . . .
. . . . . . . C . . . . . . . . . . . . . . . . | . . . . . . . . . C . . . S S S . . . . . . . . . . . . . . . . . . . . . . .
. C . . . S S S . . . . . . . . S S . . . . . . | . . . . . . . . S S S . . . . . . C . . . . . . . . . . . . . . . . . . . . .