. . . . . . . . . . . . . . . . . . . . . . . . | . . . . . . . . . . . . . . . . . . . .
. . . . . . . . . . S S S S S . . . . . . . . . | . . . . . . . . . . . . . . . . . . . .
. . . . . . . . . . . . . . . . . . . . . S S . | . . . . . . . . . . . . . . . . . . . .
. . . . . . . . . . . . . . . . . . . . . . . . | . . . . . . . . . . . . . . . . . . . .
. . . S S S S S . . . . . . . . . . S S S . . . | . . . . . . . . . . . . . . . . . . . .
. . . . . . . . . . . . . . . . . . . . . . . . | . . . . . . . . . . . . . . . . . . . .
. . . . . . . . . . . . S S S . . . . . . . . . | . . . . . . . . . . . . . . . . . . . .
. . . . . . . . . . . . . . . . . . . . . . . . | . . . . . . . . . . . . . . . . . . . .
. . . . . . . . . . . . . . . . . . . . S S S S | . . . . . . . . . . . . . . . . . . . .
. . . . . . S S . . . . . . . . . . . . . . . . | . . . . . . . . . . . . . . . . . . . .
. . S . . . . . . . . . . . . . . S . . . . . . | . . . . . . . . . . . . . . . . . . . .
. . . . . . . . . . . . . . . . . . . . . . . . | . . . . . . . . . . . . . . . . . . . .
. . . . . . . . . . S S S S . . . . . . . . . . | . . . . . . . . . . . . . . . . . . . .
. . . . . . . . . . . . . . . . . . . . . . . . | . . . . . . . . . . . . . . . . . . . .
H . . . . S S S . . . . . . . . S S . . . . . . | . . . . . . . . . . . . . . . . . . . .